XXXXXXXXXXXXXXXXX
X               X
X   X X   X X   X
X   X X   X X   X
X     X   X     X
X   X X   X X   X
X   X X   X X   X
X  XXXXX XXXXX  X
X               X
X  XXXXX XXXXX  X
X   X X   X X   X
X   X X   X X   X
X     X   X     X
X   X X   X X   X
X   X X   X X   X
X               X
XXXXXXXXXXXXXXXXX